NTPServer	KEYWORD2
WiFiNTPServer	KEYWORD2
setStratum	KEYWORD2
setMaxPollInterval	KEYWORD2
setServerPrecision	KEYWORD2
setRootDelay	KEYWORD2
setRootDispersion	KEYWORD2
setReferenceId	KEYWORD2
setReferenceTime	KEYWORD2
getElapsedTimeSinceSync	KEYWORD2
getCurrentTime	KEYWORD2
isClockSynchronized	KEYWORD2
invalidateTimeSynch	KEYWORD2
update	KEYWORD2
getSuccessfulRequests	KEYWORD2
getFailedRequests	KEYWORD2
onReadVariable	KEYWORD2


# Errors

L_NTP_R_ERROR	LITERAL1
L_NTP_R_SUCCESS	LITERAL1
L_NTP_R_NOT_SYNCHED	LITERAL1

# Debug levels

TL_NTP_ERROR	LITERAL1
TL_NTP_WARN	LITERAL1
TL_NTP_INFO	LITERAL1
TL_NTP_DEBUG	LITERAL1

# Reason Codes

L_NTP_UNSUPPORTED_VERSION	LITERAL1
L_NTP_MISSING_DATA	LITERAL1
L_NTP_TOO_MUCH_DATA	LITERAL1
L_NTP_BAD_REQUEST	LITERAL1
L_NTP_NOT_IMPLEMENTED	LITERAL1
L_NTP_BAD_VARIABLENAME	LITERAL1

# NTP Protocol Items

L_NTP_LI_NONE	LITERAL1
L_NTP_LI_61SEC	LITERAL1
L_NTP_LI_59SEC	LITERAL1
L_NTP_LI_UNSYNCH	LITERAL1
L_NTP_VERSION	LITERAL1
L_NTP_MIN_VER	LITERAL1
L_NTP_MAX_VER	LITERAL1
L_NTP_MODE_CLIENT	LITERAL1
L_NTP_MODE_SERVER	LITERAL1
L_NTP_MODE_BROADCAST	LITERAL1
L_NTP_MODE_CONTROL	LITERAL1
L_NTP_CTL_READVAR	LITERAL1

# Stratums

L_NTP_STRAT_UNSPECIFIED	LITERAL1
L_NTP_STRAT_PRIMARY	LITERAL1
L_NTP_STRAT_SECONDARY	LITERAL1
L_NTP_STRAT_UNSYNCHRONIZED	LITERAL1
